1111111111111
10010000000C1
10000111110X1
1PC011E000X01
10001000X0001
1111111111111